XXXXXXXXXXXXXXXXXXXXXXXXXXXXXXXXXXXXXXXXX
X...X.......X.........X.X...X...X.....XFX
X.X.X.XXX.X.X.XXXXX.X.X.X.X.X.X.X.X.X.X.X
X.X...X.X.X.X.X...X.X...X.X.X.X.X.X.X...X
X.XXXXX.X.X.XXX.X.X.XXXXX.X.X.XXXXX.XXX.X
X.X.....X.X.....X...X...X.X...X.....X...X
X.XXX.XXX.XXX.XXXXXXX.X.X.XXXXX.XXXXX.XXX
X...X...X.X...X.....X.X...X...X...X...X.X
XXX.XXX.X.XXXXX.XXX.X.XXXXX.XXX.X.X.XXX.X
X.X.X...X.....X.X.X...X.X.....X.X.X.....X
X.X.X.X.XXXXX.X.X.XXXXX.X.XXX.X.X.XXXXX.X
X.X...X.X.....X.X.....X.X...X...X...X.X.X
X.XXXXX.X.XXXXX.X.XXX.X.XXX.XXXXXXX.X.X.X
X.......X...X...X...X.X...X.X...X...X...X
XXXXXXXXXXX.X.XXXXX.X.XXX.X.XXX.X.XXXXXXX
X...........X.X.....X.X...X.....X.X.....X
X.X.XXXXXXXXX.X.XXXXX.X.XXXXXXX.X.X.XXX.X
X.X.X.........X.X.....X.X.....X.X...X...X
X.XXX.XXXXXXXXX.X.XXXXX.X.XXX.X.XXXXX.X.X
X.X...X.........X.....X.X.X.X.......X.X.X
X.X.XXX.XXX.XXXXXXXXX.X.X.X.XXXXXXXXX.X.X
X...X.X...X.......X.X...X.X...X.......X.X
X.XXX.XXX.XXXXXXX.X.XXX.X.X.XXX.XXX.XXXXX
X...X.X...X...X...X.....X.X.X...X...X...X
XXX.X.X.XXXXX.X.X.XXXXX.X.X.X.XXX.XXX.X.X
X...X...X...X.X.X.X...X.X.X.X...X...X.X.X
X.XXXXX.X.X.X.X.XXX.X.XXX.X.XXX.XXX.X.X.X
X.....X...X...X.....X.X.....X...X.X.X.X.X
XXXXX.XXX.XXXXXXXXXXX.X.XXXXX.XXX.X.X.X.X
X...X.X...X.....X...X...X...X...X...X.X.X
X.XXX.X.XXX.XXX.X.X.XXXXX.X.X.X.XXXXX.X.X
X.X...X.X...X...X.X...X...X.X.X.......X.X
X.X.XXX.X.XXX.XXX.XXX.X.XXX.XXX.XXXXXXX.X
X...X...X...X.....X...X.X.X...X...X...X.X
X.XXXXXXXXX.XXXXXXX.XXX.X.XXX.XXXXX.X.X.X
X.X.......X...X.....X...X.X...X...X.X...X
X.XXX.XXX.X.X.X.XXXXX.XXX.X.XXX.X.X.XXXXX
X.....X...X.X.X.....X...X...X...X.X.....X
XXXXXXX.XXXXX.XXXXX.XXX.X.XXX.XXX.XXXXX.X
XI............X.........X.....X.........X
XXXXXXXXXXXXXXXXXXXXXXXXXXXXXXXXXXXXXXXXX