XXXXXXXXXXXXXXXXXXXXXXXXXXXXXXXXXXXXXXXXXXXXXXXXXXXXXXXXXXXXX
X...X.......X...X.................X.....X.....X.....X......FX
X.XXX.X.XXXXX.X.X.XXXXXXX.XXXXXXXXX.X.X.X.XXXXX.X.XXX.XXXXX.X
X.X...X.......X.X.X.....X.......X...X.X.X...X...X.........X.X
X.X.XXXXXXXXXXX.X.X.XXX.XXXXXXX.X.XXX.X.XXX.X.XXXXXXXXXXXXX.X
X...X.X...X...X...X...X.......X.....X.X.....X.X...X...X...X.X
X.XXX.X.X.X.X.XXX.XXX.XXXXXXX.XXXXX.X.XXXXXXX.X.X.X.XXX.X.X.X
X.X.....X.X.X...X.X.X.X.....X...X.X.X.....X.....X...X...X...X
X.XXXXXXX.X.XXX.X.X.X.X.X.X.XXX.X.X.XXXXX.X.XXXXXXXXX.XXXXXXX
X.........X.X.X.X...X.X.X.X.X...X.X.....X...X.......X.X.....X
XXXXXXX.XXX.X.X.X.XXX.X.X.X.X.XXX.X.XXXXXXXXX.XXXXX.X.XXX.X.X
X.....X.X...X...X.X...X.X.X.X...X...X...X.....X...X.X.X...X.X
X.XXXXX.X.XXX.XXXXX.XXX.X.XXXXX.XXXXX.X.X.XXXXX.XXX.X.X.XXXXX
X.X.....X.X...X...X.X.X.X.....X.......X.X.X...........X.....X
X.X.XXXXX.X.XXX.X.X.X.X.XXX.X.XXXXXXXXX.X.XXXXX.XXXXXXXXXXX.X
X.X.....X.X.X...X.X.X.....X.X.X.......X.X.....X.X.....X...X.X
X.XXXXX.X.X.XXX.X.X.XXXXXXX.XXX.XXXXX.X.XXXXX.XXX.XXX.X.X.X.X
X.X.....X.X.....X.X.X.....X...X...X...X.X.....X...X...X.X.X.X
X.X.XXXXX.XXXXXXX.X.X.XXX.XXX.XXX.X.XXX.X.XXX.X.XXX.XXX.X.X.X
X.X.X...X...X.X.....X...X...X.....X.....X.X...X.X.X.X...X...X
X.X.X.X.XXX.X.X.XXXXXXX.XXX.X.XXXXXXXXXXX.XXXXX.X.X.X.XXXXX.X
X...X.X...X.X...X.X...X.X...X.X.X.................X.X.....X.X
X.XXX.X.XXX.X.XXX.X.X.X.X.XXX.X.X.XXXXXXXXXXXXXXXXX.XXXXX.X.X
X.X...X.X...X.....X.X.X.X...X.X...X.....X.........X.....X.X.X
X.XXX.XXX.XXXXXXXXX.X.X.XXX.X.XXX.X.X.XXX.XXXXXXX.X.XXX.X.XXX
X...X.X...X.........X...X...X...X...X.X...X.....X.X...X.X...X
XXX.X.X.XXX.XXXXXXXXXXXXX.XXXXX.X.XXXXX.XXX.XXX.X.XXXXX.X.X.X
X.X.X.X...X.X.....X...X...X...X.X.X.....X...X.X.X.......X.X.X
X.X.X.XXX.X.X.XXX.XXX.XXXXX.X.X.X.X.XXXXX.XXX.X.XXXXXXXXXXX.X
X.X.X.X...X...X.X.......X...X.X.X.X.X.....X.....X.....X.....X
X.X.X.X.XXXXXXX.XXXXXXX.X.X.XXX.XXX.X.XXXXX.XXXXX.X.XXX.X.XXX
X...X.X.........X.......X.X...X.....X.X.....X...X.X.....X...X
X.XXX.XXXXXXX.X.X.XXXXXXX.XXX.XXXXXXX.X.XXXXXXX.X.XXXXXXXXX.X
X.....X...X.X.X.X...X...X...X.........X.......X.X.....X.....X
XXXXX.X.X.X.X.XXXXX.X.XXXXX.XXXXXXX.XXXXXXXXX.X.XXX.XXX.XXX.X
X...X...X...X.......X.......X.....X.X.......X.X.....X...X...X
X.XXXXXXXXX.XXXXXXXXX.XXXXXXX.XXX.X.XXX.XXX.X.XXXXXXX.XXX.XXX
X.......X...X.....X.X.X.......X...X...X.X...X.........X...X.X
X.XXX.X.X.XXXXX.X.X.X.XXX.XXXXXXX.XXX.X.X.XXXXXXXXXXXXX.XXX.X
X...X.X.X.X.....X...X...X...X...X...X.X.X...X.....X.....X...X
X.XXX.XXX.X.XXXXXXXXXXX.XXX.X.X.XXXXX.X.XXXXX.XXX.X.XXXXX.XXX
X.X...X...X.............X...X.X.......X.......X...X...X.....X
X.X.XXX.XXXXXXXXXXX.XXXXX.X.X.XXXXXXXXX.XXXXXXX.XXXXX.XXXXX.X
X.X.X...X.....X...X.X.....X.X.X.......X.X.....X.............X
XXX.X.XXX.XXX.X.X.X.X.XXXXX.X.X.XXXXX.XXX.XXX.XXXXXXXXXXXXX.X
X...X.X.....X...X.X...X.....X...X...X.....X.X.X.......X.....X
X.XXX.XXXXX.XXXXX.XXXXXXXXXXXXXXX.X.XXXXX.X.X.X.XXXXX.X.XXXXX
X...X.......X...X.X.......X.......X.X...X...X.......X.X.....X
X.X.XXXXXXXXX.X.X.X.XXXXX.X.XXXXXXX.X.X.XXXXXXXXXXX.X.XXXXX.X
X.X...X.......X.X...X...X...X...X...X.X.........X.X.X.....X.X
X.X.XXX.XXXXXXX.XXXXX.XXXXXXX.X.X.XXX.XXXXXXXXX.X.X.XXXXX.XXX
X.X...X.....X.X.....X.......X.X.X.....X...X.....X.......X...X
X.XXX.XXXXX.X.XXX.XXX.XXX.XXX.X.XXXXXXXXX.X.XXXXXXXXX.XXXXX.X
X...X.....X.X.X...X...X...X...X...........X.X.....X...X.....X
XXX.X.XXXXX.X.X.XXX.XXX.X.X.XXX.XXXXXXXXX.X.X.XXX.X.XXX.XXX.X
X.X.X.X.....X.X.X...X.X.X.X.X.X.X.......X.X.X...X.X...X...X.X
X.X.X.X.XXXXX.X.X.XXX.X.XXX.X.X.X.X.XXXXX.X.XXX.X.XXX.XXX.X.X
X...X.X...X...X...X...X.X...X.X.X.X.......X...X.X.X.....X.X.X
X.XXX.XXX.X.X.XXXXXXX.X.X.XXX.X.XXXXXXXXXXXXX.X.X.XXXXXXX.X.X
XI..X.......X.........X.......X.................X.........X.X
XXXXXXXXXXXXXXXXXXXXXXXXXXXXXXXXXXXXXXXXXXXXXXXXXXXXXXXXXXXXX