XXXXXXXXXXXXXXXXXXXXX
X.......X.....X....FX
X.XXXXX.X.XXX.X.XXX.X
X...X...X...X.....X.X
XXX.X.XXXXX.XXXXXXX.X
X...X...X...X...X...X
X.XXXXX.X.XXXXX.X.XXX
X.X...X.X.....X.X...X
XXX.X.X.XXXXX.X.XXX.X
X...X.X...X.......X.X
X.XXX.X.XXX.XXXXX.X.X
X.X...X.....X.X...X.X
X.X.XXXXXXXXX.XXXXX.X
X.X...X.......X.....X
X.XXX.X.XXXXXXX.XXX.X
X...X.X...X...X...X.X
XXX.X.XXX.X.X.XXX.X.X
X.X.X.....X.X.X...X.X
X.X.XXXXXXX.X.X.XXX.X
XI..........X...X...X
XXXXXXXXXXXXXXXXXXXXX